111111111111111111111111111111111111111111111111111111111111
111111111111111111111111111000000000000000000011111111111111
11111111111111111111111111001111111111111111100000000000000!
111111111111111111111111100000000111111111111111111111111111
111111111111111111111111111111110111111111111111111111111111
111111111111111111111111111111110111111111111111111111111111
111111111111111111111111111111110000000000011111111111111111
111111111111111111111111111111111111111111011111111111111111
111111111111111111111111111111111111111111011111111111111111
111111111111111111111111111111111000000000011111111111111111
111111111111111111111111111111111011111111111111111111111111
1111111111111111111111111111111110<1111111111111111111111111
