1111111!1
1v1000101
101010101
100010001
111111111
