111!1
1v101
10101
10001
11111
